NO ./skyline128.xpm
WE ./skyline128.xpm
SO ./skyline128.xpm
EA ./skyline128.xpm
F 14, 5, 6

C 14, 5, 


111111 11111111111
10000010000000001
 10000000011000001
1000000001  10011
1000000001  10001
10000N0001  10001
 111111111  1111
