NO ./skyline128.xpm
WE ./skyline128.xpm
SO ./skyline128.xpm
EA ./skyline128.xpm
F 14, 5, 6
C 14, 5, 6

11111111111111111
10000000000000001
10101010101010101
10000000000000001
11010101010101011
10000N00000000001
11111111111111111
