11111111111111111111
10000000000000000001
10N00000000000010001
10000000000000000001
1000000000000000000
11111111111111111111
