NO ./cactus64.xpm

SO ./cactus64.xpm

EA ./kakka.xpm
WE ./cactus64.xpm
F 0, 100, 100
C 100, 100, 10

111111111 111
1100000001001
1000N00000001
1000000001001
111111111111
