NO ./textures/north256.xpm
WE ./textures/west256.xpm
SO ./textures/south256.xpm
EA ./textures/east256.xpm

F 255, 255, 255
C 255, 255, 255


11111111111111111
10000000000000001
10000000000000001
10000000000000001
10000000000000001
10000N00000000001
11111111111111111