     NO               ./textures/cactus64.xpm
SO ./textures/cactus64.xpm
WE ./textures/cactus64.xpm
EA ./textures/cactus64.xpm
F 0, 255, 255
C 40, 50, 100


            



1111111111111111
1000000000000001
1010000000011001
1000000000001001
1000000000000001
10000N0000000001
1111111111111111


